T...T...T
.####.##.
.####....
.#######.
SA......E
.#######.
.###P###M
.##...##.
M.......M