###P#.......
T.#T..#.###E
..M.##..TT##
##....M###.P
P#...#......
M###.P#.##M#
...M..#.#..#
M###.......#
T#.M....##.#
##.####.##..
#SA#..M.##.T
####T.######