####.#T.#.P#
T###..#.#..#
.#..#.....##
..#...##..##
#.#...####T#
..#.#.M.T.M.
M...#.##..#.
.##.MP#PM.E.
T#T#####.##T
.M..##...###
M#M#.##.####
P#SA.#######