#SA.M.T#####
P#..####....
..M.#P##.##E
#.#T..#..#T.
###.#.#.##.#
##.M..M.##M#
PM.#...#...T
#..##..#M..T
##T###...#.#
#T###..###P#
..#.M.######
.....#######