PMT.#TM#T###
T#..TTP.P...
M#...#.T.T.#
T#P#.....P#.
PM.##.PPM#T.
#P.#T.MTM.TP
#.#M.P.T.MM#
T#...PT.....
.MM#M.#..#SA
##T#.TT.T...
#PM.P..#.PT#
....M#E.#MM#