#####T.#####
####.#M####T
##S#....MP#T
##A#M#..#...
##...#......
##P.#.......
T###M.#T###P
..##.###ME##
..T#.....###
##..M###M###
#PM.####T###
##....######