T######.T#AS
.#.......#..
.#....#M##..
M#M####PP#..
......##M#..
T#..........
.########M##
.#T.T#P.#.P#
.#...#..#T.#
T##M###M##.#
....#E#....#
###...M.####