##T..#####.P
####.#T###..
#.T#.#...#..
#M#.M..#...#
P...#..##.##
#M##..#P#.M.
.....##M#.#T
T.##.##...##
..##T#E#.T##
#MP##..#M###
#...M..#.###
######.#AS##